11111111111111111111
10000000001100000001
10000001000000010001
10100000000000001001
1P100001000000000CE1
11111111111111111111