1111111111111111111111111
1C000C000000C000000C000C1
10C0C1C00000E00000C1C0C01
100111111C11111C111111001
10C0C1C00000P00000C1C0C01
1C000C000000C000000C000C1
1111111111111111111111111